-----------------------------------------------------------------------------------------------------
|                                                                                                   |
|  --------------------  ---------------------------------------------------  --------------------  |
|  |                  |  |                                                 |  |                  |  |
|  |                  |  |                                                 |  |                  |  |
|  |                  |  |                                                 |  |                  |  |
|  |                  |  |                                                 |  |                  |  |
|  |                  |  |        |-------------------------------|        |  |                  |  |
|  |                  |  |        |                               |        |  |                  |  |
|  |                  |  |        | ----------------------------- |        |  |                  |  |
|  |                  |  |        | |                           | |        |  |                  |  |
|  --------------------  ---------- ----------------------------- ----------  --------------------  |
|                                                                                                   |
|  --------------------  ---------------------------------------------------  --------------------  |
|  |                  |  |                                                 |  |                  |  |
|  |                  |  |                                                 |  |                  |  |
|  |                  |  |                                                 |  |                  |  |
|  |                  |  |                                                 |  |                  |  |
|  |                  |  |                                                 |  |                  |  |
|  |                  |  |                                                 |  |                  |  |
|  |                  |  |                                                 |  |                  |  |
|  |                  |  |                                                 |  |                  |  |
|  |                  |  |                                                 |  |                  |  |
|  --------------------  ---------------------------------------------------  --------------------  |
|                                                                                                   |
|           -----------  ---------------------------------------------------  --------------------  |
|           |         |  |                                                 |  |                  |  |
|           |         |  |                                                 |  |                  |  |
|           |         |  |                                                 |  |                  |  |
|           |         |  |                                                 |  |                  |  |
|           -----------  ---------------------------------------------------  --------------------  |
|                                                                                                   |
|                                       ----------------------                                      |
|                                       |          0         |                                      |
-----------------------------------------------------------------------------------------------------